11111111111
1C0000E0111
1E000CCE111
1P000CE1111
11111111111